_________________
|               |
|   #########   |  
|   #  ###  #   |
|   #  #@#  #   |
|   #  ###  #   |
|   ########$   |
|               |
|_____MOATS_____|