_________________
|               |
|   #########   |
|   #  ###  #   |
|   #  #@#  #   |
|   #  ###  d   |
|   #######m$   |
|               |
|_____MOATS_____|