#########
#  ###  #
#  #@#  #
#  ###  #
########$
