
 #########
 #  ###  #
 #  #@d  #
 #  ###  #
 ########$
