
 #########
 #  ###  #
 #  #@#  #
 #  ###  d
 #######d$
