#########
#  ###  #
#  #c#  #
#  ###  #
########$
