
 #########
 #  ###  #
 #  #@#  #
 #  ###  d
 #######m$
              
