
 #########
 #  ###  #
 #  #@#  #
 #  #s#  d
 #######m$
