
 #########
 #  ###  #
 #  #@#  #
 #  ###  d
 ####s##m$
          
